********
* * ***
**  *  *
** *** *
*   * **
*   *  *
*** * **
*** ****
